WWWWWWWWWWWWWWWWWWWWWWWWWWWWWW
W............................W
W............................W
W..................W.........W
W....WWWW.....WWW..WW........W
W............................W
WC............WWW........W...W
W........W.............WW....W
W.......WW............WWW....W
W....WWWWWWWWWWWWWWWWWWWWWWWWW