WWWWWWWWWWWWWWWWWWWWWWWWWWWWWW
W............................W
W............................W
W..................W.........W
W....WWWW.....WWW..WW........W
W..................WWWW......W
W........C....WWW........W...W
W........W.............WW....W
W.......WW............WWW....W
WWWWWWWWWWWWWWWWWWWWWWWWWWWWWW