WWWWWWWWWWWWWW
W............W
W............W
W......P.....W
WWWWWWWWWWWWWW