WWWWWWWWWWWWWW
W............W
W............W
W............W
W......C.....W
WWWWWWWWWWWWWW